R 1200 800
F 255,40,60
C 50,10,123
WE ./textures/west.xpm
SO ./textures/south.xpm
EA ./textures/east.xpm
NO ./textures/north.xpm
S ./textures/barrel.xpm

              1
            11111
          111   111
        111       111   111
      111           111 1 1
    111               111 1
  111                   111
11111111111111111111111111111
10000000000000000000000000001
10001111111111111100010000001
10000100101      101000E00001
10100000001      100000000001
10100000001      100020220001
10000000001111111101111111001
10000000002000000001     1001
10000000000000000001     1001
10001000102000010001    11001
10100010002010000101     1001
11111111111111111111111111111
111                       111
